WWWWWWWWWWWW
WFDFFFFFFFFW
WFFFFFFFCFFW
WFFFFFCFFFFW
WFFFFFFFPFFW
WFFFFFFFFFFW
WFFFFFFFFFFW
WFFDFFFFFFFW
WFFFFFFFFFFW
WFFCFFFFDFFW
WFFFFFFFFFFW
WWWWWWWWWWWW