WWWWWWWWWWWW
WFFFFFFFFFFW
WFFFFFFFCFFW
WFFDFFCFFFFW
WFFFDFFCFFFW
WFFFFDFWFFFW
WFFDTFFWFFFW
WFFFWWFWFFFW
WFFCFFFWFFFW
WFFFDFCFFFFW
WFFPFFFFFFFW
WWWWWWWWWWWW
