WWWWWWWWWWWW
WFFFFFFFFFFW
WFFFFFFFCFFW
WFFDFFCFFFFW
WFFFFFFCFFFW
WFFFFDFWFFFW
WFFDTFFWFFFW
WFFFWWFWDFFW
WFFCFFFWFFFW
WFFFDFCWFFFW
WFFPFFFFFFFW
WWWWWWWWWWWW
