WWWWWWWWWWWW
WFFFFFFFFFFW
WFFFFFFFCFFW
WFFDFFCFFFFW
WFFFFFFFFFFW
WFFFFFFFFFFW
WFFDTFFWFFFW
WFFFWWFWFFFW
WFFCFFFDFFFW
WFFFFFFFFFFW
WFFPFFFFFFFW
WWWWWWWWWWWW