WWWWWWWWWWWW
WFFFFFFFFFFW
WFDFFFFFCFFW
WFFFFFCFFFFW
WFFFFFFFPFFW
WFFFTFFFFFFW
WFFFFFFFFFFW
WFFDFFFFFFFW
WFFFFWWWWWFW
WFFCFFFFDFFW
WFFFFFFFFFFW
WWWWWWWWWWWW